22222222
20004442
20000002
20220002
20300202
20300032
20102002
22222222
