22222222
20000042
20302002
20200002
20300202
20020002
20102242
22222222
