22222222
20044242
20320002
20000002
20300202
20020032
20100002
22222222
